11 15
.   .   .   .   .   .   .   .   .   .   .   .   .   .   .   
.   .   .   .   .   .   .   .   .   .   .   .   .   .   .   
.   .   .   .   .   .   .   .   .   .   .   .   .   .   .   
.   .   .   .   .   .   .   .   .   .   .   .   .   .   .   
.   .   .   .   .   .   .   .   .   .   .   .   .   .   .   
.   .   .   .   .   .   .   .   .   .   .   .   .   .   .   
.   .   .   .   F   .   .   .   .   .   .   .   .   .   .   
.   .   .   .   .   .   .   .   .   .   .   .   .   .   .   
.   .   .   .   .   .   .   .   .   M   .   .   .   .   .   
.   .   .   .   .   .   .   .   .   .   .   .   .   .   .   
.   .   .   .   .   .   .   .   .   .   .   .   .   .   .   
