11 15
.   .   .   .   .   .   .   .   .   .   .   .   .   .   .   
.   .   .   .   .   .   .   .   .   .   .   .   .   .   .   
.   .   .   .   .   .   .   .   .   .   .   .   .   .   .   
.   .   WA0 WL0 WA1 .   .   .   .   .   WA0 WL0 WA1 .   .   
.   .   WL1 G   WL3 .   .   .   .   .   WL1 G   WL3 .   .   
.   .   WL1 G   G   WL0 WA1 .   WA0 WL0 G   G   WL3 .   .   
.   .   WL1 G   G   G   WL3 .   WL1 G   G   G   WL3 .   .   
.   .   WL1 G   G   G   WL3 .   WL1 G   G   G   WL3 .   .   
.   .   WL1 G   G   G   G   WL0 G   G   G   G   WL3 .   .   
.   .   WL1 G   G   G   G   G   G   G   G   G   WL3 .   .   
.   .   WL1 G   G   G   G   E   G   G   G   G   WL3 .   .   
