11 19
.   .   .   .   .   .   .   .   .   .   .   .   .   .   .   .   .   .   .   
.   .   .   .   .   .   .   .   .   .   .   .   .   .   .   .   .   .   .   
.   .   .   .   .   .   .   .   .   .   .   .   .   .   .   .   .   .   .   
.   .   .   .   .   .   .   .   .   .   L1  .   .   .   .   .   .   .   .   
.   .   .   .   .   .   .   .   .   .   .   .   .   .   .   .   .   .   .   
.   .   .   .   .   .   .   .   .   .   .   .   .   .   .   .   .   .   .   
.   .   .   .   .   .   .   .   .   .   .   .   .   .   .   .   .   .   .   
.   .   .   L0  .   .   .   .   .   .   .   .   .   .   .   .   .   .   .   
.   .   .   .   .   .   .   .   .   .   .   .   .   .   .   .   .   .   .   
.   .   .   .   .   .   .   .   .   .   .   .   .   .   .   .   .   .   .   
.   .   .   .   .   .   .   .   .   .   .   .   .   .   .   .   .   .   .   
